15 7
120
BBBB BBRR RGBG BBRG BBBB MGRB MMBR BRMM MBBM BRBB RRRR RGGR BYBB BBBB BBBB
BBBB BRBR RRRR RRRR BBBB BBBB GGGG GGGG GGGG BBBB BBBB YMMY BBBB YBBY BBBB
RRRR BBBB BBBB RRRR MMMM RMMG BBBB BBBB GGGG BBBB BBBB CMMC BBBB YRYR BBBB
BBBB RRRR RRRR MMMM MMMM BBBB GGGG GRRB MRRM RRRR RGGR YYMM YYYY YYYY BBBB
BBBB RRRR MRRG MGGM GRRG BBBB BBBB BBBB GGGG MRRM RBGR BRBR BBBB BYYB BBBB
BBBB RRRR RGMB RGRY GRRB BBBB GGGG BRRG GGGG BBBB BBBB YYYY MRRB BRBY BBBB
BBBB BBBB BBBB BBBB RGRR BBBB BBBB BBBB BBBB RGBM BBBB BBBB MMMM BBBB BBBB

P 4 4

door 5 2

FA DOWN null 5 5

FFT RIGHT B 6 1

clock null 2

gate blue 2

gate red 1

gate green 2

lever blue 1

lever red 1

lever green 1

bomb null 3

loot dollar 7
loot gold 4
loot ruby 4
loot diamond 3