15 7
120
BBBB BBBB BBBB BBBB BBBB BBBB BBBB BBBB BBBB BBBB BBBB BBBB BBBB BBBB BBBB
BBBB BRBR RRRR RRRR BBBB BBBB GGGG GGGG GGGG BBBB BBBB YMMY YYYY YYYY BBBB
BBBB BBBB BBBB RRRR BBBB BBBB BBBB BBBB GGGG BBBB BBBB CMMC BBBB YRYR BBBB
BBBB RRRR RRRR RRRR BBBB BBBB GGGG GGGG GYGY BBBB BBBB YYMM BBBB YYYY BBBB
BBBB RRRR BBBB BBBB BBBB BBBB BBBB BBBB GGGG BBBB BBBB YYYY BBBB BYYB BBBB
BBBB RRRR RRRR RGRY BBBB BBBB GGGG GGGG GGGG BBBB BBBB YYYY YYYY YYYY BBBB
BBBB BBBB BBBB BBBB BBBB BBBB BBBB BBBB BBBB BBBB BBBB BBBB BBBB BBBB BBBB

P 6 3

door 13 6

FA DOWN null 9 3

FFT RIGHT B 1 2

clock null 2

gate blue 2

gate red 1

gate green 2

lever blue 1

lever red 1

lever green 1

bomb null 3

loot dollar 5
loot gold 4
loot ruby 3
loot diamond 2