15 7
120
MMMM MMMM MMMM MMMM MMMM MMMM MMMM MMMM MMMM MMMM MMMM MMMM MMMM MMMM MMMM
BBBB MBMB GBBB BGGG MMMM GBGG RGRG RRRR MMMM YBYY YYYY YYBY BBBB BMBB BBRB
MMMM BBYB MMMM GGGG MMMM RGGG RRRR MMMM GRGR YYYY MMMM MMMM BGBB MMMM MMMM
MMMM GBBG MMMM GGRG MGGG GBGG RRRB RRMR MMMM YGYG YYYY MMMM BBBM BBBB MMMM
MMMM RGBB MMMM GBGB MMMM RGGG RRGR MMMM GRRR BYYY MMMM MMMM BBBB MMMM MMMM
MMMM BBBB MMMM GBGG MMMM GGGG RRRR MMMM RYRR YYYY YMYY YYYB BBBB RBBB BBBB
MMMM MMMM MMMM MMMM MMMM MMMM MMMM MMMM MMMM MMMM MMMM MMMM MMMM MMMM MMMM

P 4 4

door 5 2

FA DOWN null 5 5

FFT RIGHT B 6 1

clock null 2

gate blue 2

gate red 1

gate green 2

lever blue 1

lever red 1

lever green 1

bomb null 3

loot dollar 7
loot gold 4
loot ruby 4
loot diamond 3