15 7
170
YYGG YYYY BBBB BBBB BBBB BBBB BBBB BBBB BBBB BBBB BBBB BBBB BBBB BBBB BYBY
BBBB BBBB BRRR RRRR RRRR RRRB YBBY YYYY YYYY YYYY BBBB BBBB BBBB BBBB BBYY
GGYY BBYY BBBB BBBB BBBB BBBB MMMY YBBB BBBB CCCC CCCB BBBB BBBB BBBB YYYY
YYYY YYYY BBBB BBBB BBBB RYRY MYYY YCCC BBBB CBBB BBBB BBBB BBBB YYYY YYYY
YYBB BBBB BBBB RRRR RRYY YYYY MMMM CCBB BBBB BBBB RRRR RRRR RRYY RRRR YYYY
YBBB BBBB BBBB RBBB RRBB YYYY GGGG GGGG GGGG GGYY GGGY GRRR GGRR GGGR YYYY
BBBB BBBB BBBB BBBB BBBB YYYG GGGR GGRR BBBB BBBB BGGB BBBB BBBB BBBB BBBB

P 4 4

door 5 2

FA DOWN null 5 5

FFT RIGHT B 6 1

clock null 2

gate blue 2

gate red 1

gate green 2

lever blue 1

lever red 1

lever green 1

bomb null 3

loot dollar 7
loot gold 4
loot ruby 4
loot diamond 3