15 7
120
RRRR RRRR RRRR RRRR RRRR RRRR RRRR RRRR RRRR RRRR RRRR RRRR RRRR RRRR RRRR
RRRR GGGG GGRG GGGG RRRR BBYY BBBB BBYB RRRR YYYB RRRR YYBY RRRR MMMM RRRR
RRRR GYGG RRRR RRRR RRRR RRRR BBMM RRRR RRRR YYYY RRRR YYYY RRRR MMMM RRRR
RRRR GGGG GGYG GGGG RRRR RRRR BBBB RRRR RRRR RRRR YGYY RRRR RRRR MRMM RRRR
RRRR RRRR RRRR GYGY RRRR RRRR BBBB RRRR RRRR GYYY RRRR YYYY RRRR RRRR RRRR
RRRR GGGG GMMG GGGG RRRR BBBB YBBB BBBB RRRR YYYM RRRR GYGY RRRR MMMM RRRR
RRRR RRRR RRRR RRRR RRRR RRRR RRRR RRRR RRRR RRRR RRRR RRRR RRRR RRRR RRRR

P 4 4

door 5 2

FA DOWN null 5 5

FFT RIGHT B 6 1

ST UP null 2 6

clock null 2

gate blue 2

gate red 1

gate green 2

lever blue 1

lever red 1

lever green 1

bomb null 3

loot dollar 7
loot gold 4
loot ruby 4
loot diamond 3